..........
..........
..........
..........
..........
..........
......###.
......#T#.
......###.
..........
