*********.
*********.
*********.
*********.
*********.
**********
******###*
******#***
******###.
******....
