*****.....
*****.....
*****.....
*****.....
*****.....
*****.....
###.*.....
#*#.*......###.........
.****.....
